# Syntax: IdInJiffy=Section1/../SectionN
# Spaces are allowed in any part of the line
# Order of the sections in the report will replicate the order of lines here

Работа-Прогр=Day Job/Programming
Работа-Отладк=Day Job/Debugging
Работа-Собрания=Day Job/Social
Работа-Обучение=Day Job/Learning
Работа=Day Job/Other

ПисатАнг=Writing/In English
ПисатАнг-ПрзПисат=Writing/In English/Novel/Writing
ПисатАнг-ПрзПроч=Writing/In English/Novel/Other
ПисатАнг-ПрзРедакт=Writing/In English/Novel/Editing
ПисатАнг-ПрочПисат=Writing/In English/Other
ПисатАнг-ПрочРедакт=Writing/In English/Other

Блог-БлогПисат=Writing/In Russian/Blog/Writing
Блог=Writing/In Russian/Blog/Other

Чтение-КнигиАнг=Learning/Reading/Books/In English
Чтение-КнигиПисат=Learning/Reading/About Writing/Books
Чтение-ПрочПисат=Learning/Reading/About Writing/Other
Чтение-КнигиИсп=Learning/Reading/Books/In Spanish
Чтение-ПрочЧтАнг=Learning/Reading/Other/In English
Чтение-ПрочЧтИсп=Learning/Reading/Other/In Spanish
Чтение-ПрочЧтРус=Learning/Reading/Other/In Russian

Англ=Learning/English
Англ-ПвтСлов=Learning/English/Vocabulary
Англ-ПвтСловV=Learning/English/Vocabulary
Англ-ГраматУпр=Learning/English/Grammar
Англ-Elevate=Learning/English/Elevate
Англ-Произн=Learning/English/Pronounciation

Французский=Learning/French
Французский-Pimsleur=Learning/French/Pimsleur
Французский-ПвтСлов=Learning/French/Vocabulary
Французский-ГраматУпр=Learning/French/Grammar

Прогр-ВидеоТехн=Learning/Programming/Tech Video
Прогр-ПрогрТренинг=Learning/Programming/Exercises
Прогр-ЧтенТехнич=Learning/Programming/Tech Reading
Прогр-АудиоТехн=Learning/Programming/Tech Audio
Прогр=Learning/Programming/Other

Аудио-АКниги=Learning/Audio/Audio Books
Аудио-Театр=Learning/Audio/Theater
Аудио-ПодкПисат=Learning/Audio/About Writing
Аудио-ПодкТехн=Learning/Audio/Tech
Аудио-ПодкПроч=Learning/Audio/Other
Аудио=Learning/Audio/Other

Видео=Learning/Video/Other
Видео-ВидеоАнг=Learning/Video/In English
Видео-ВидеоИсп=Learning/Video/In Spanish
Видео-ВидеоРус=Learning/Video/In Russian

Прочее-Переписка=Social/Correspondence

Спорт-БЖЖ=Sport/BJJ
Спорт-Йога=Sport/Yoga
Спорт-Силовая=Sport/Weightlifting
Спорт-Футбол=Sport/Football
Спорт-Разминка=Sport/Warm-up
Спорт-ПингПонг=Sport/Ping-pong
Спорт=Sport/Other

Самоорг-Отчеты=Self-organization/Reports
Самоорг=Self-organization/Other

Прочее=Other/Other
Прочее-CL Generator=Other/Projects/Conscious Life Generator
Прочее-Фирма=Other/Projects/Consultancy Service
Прочее-SibEDGE=Other/Projects/SibEDGE
Прочее-Переезд=Other/Projects/Migration
Прочее-Гитара=Other/Projects/Guitar
Прочее-Rebota=Other/Projects/Rebota
Прочее-ML Challenge=Other/Projects/ML Challenge
